111111
1E1P01
100001
10C001
111111