1111111111111
10010001000C1
1000000100001
1000011111001
1000000000001
1P0011E000001
1000000000001
1111111111111