111111111111
1E0000000001
101001010011
101001001011
1000P0000C01
111111111111