11111111111111111
1E0000000000000C1
10100101001000001
10100100101010101
100010000C00C0001
100000P00000000C1
100000000000000C1
11111111111111111