11111111111111
10000000001001
10100101001001
10100100111001
1X00ECP0000001
100000000000X1
11111111111111