11111111111
1000P000011
1EC00000111
10000000001
10000010001
10000010001
11111111111